350 13 160 16 16 4 88
0 0 0 0 0 0 0 0 0 0 0 0 0 0 0 0 0 0 0 0 0 0 0 0 0 0 0 0 0 0 0 0 0 0 0 0 0 0 0 0 0 0 0 0 0 0 0 0 0 0 0 0 0 0 0 0 0 0 0 0 0 0 0 0 0 0 0 0 0 0 0 0 0 0 0 0 0 0 0 0 0 0 0 0 0 0 0 0 0 0 0 0 0 0 0 0 0 0 0 0 0 0 0 0 0 0 0 0 0 0 0 0 0 0 0 0 0 0 0 0 0 0 0 0 0 0 0 0 0 0 0 0 0 0 0 0 0 0 0 0 0 0 0 0 0 0 0 0 0 0 0 0 0 0 0 0 0 0 0 0 
0 0 0 0 0 0 0 0 0 0 0 0 0 0 0 0 0 0 0 0 0 0 0 0 0 0 0 0 0 0 0 0 0 0 0 0 0 0 0 0 0 0 0 0 0 0 0 0 0 0 0 0 0 0 0 0 0 0 0 0 0 0 0 0 0 0 0 0 0 0 0 0 0 0 0 0 0 0 0 0 0 0 0 0 0 0 0 0 0 0 0 0 0 0 0 0 0 0 0 0 0 0 0 0 0 0 0 0 0 0 0 0 0 0 0 0 0 0 0 0 0 0 0 0 0 0 0 0 0 0 0 0 0 0 0 0 0 0 0 0 0 0 0 0 0 0 0 0 0 0 0 0 0 0 0 0 0 0 0 0 
1 2 2 3 2 2 2 3 4 3 4 2 2 2 2 2 2 2 2 2 2 2 2 2 2 2 2 2 2 2 2 2 2 2 2 2 2 2 2 2 2 2 2 2 2 3 4 3 4 2 2 2 2 2 2 2 2 2 2 2 2 3 2 2 2 2 2 3 2 2 2 2 2 2 2 2 2 2 2 2 2 2 2 2 2 2 2 2 2 2 2 2 2 2 2 2 2 2 2 2 2 2 2 2 2 2 2 2 2 2 2 2 2 2 2 2 2 2 2 2 2 2 2 2 2 2 2 2 0 5 6 7 8 9 10 11 12 13 14 15 16 17 18 19 20 21 22 23 24 25 26 27 28 29 0 0 0 0 0 0 
30 1 2 31 32 33 2 34 35 31 35 2 2 2 2 2 2 36 37 38 2 2 2 2 2 2 2 2 2 36 37 38 2 2 2 2 2 36 37 38 2 2 2 2 2 31 35 31 35 2 2 36 37 38 2 2 2 36 37 38 2 31 32 33 3 33 2 34 32 33 2 2 2 2 2 36 37 38 2 2 2 2 2 36 37 38 2 2 2 2 2 2 2 2 2 2 2 2 2 2 2 2 2 2 2 2 36 38 2 2 2 36 37 38 2 2 2 2 36 38 2 2 2 2 2 36 37 38 0 39 40 41 42 43 44 45 46 47 48 49 50 51 52 0 53 54 55 56 57 58 59 60 61 62 0 0 0 0 0 0 
30 63 2 64 65 66 67 68 67 68 67 2 2 2 2 2 2 69 69 70 69 2 71 72 69 70 71 72 2 2 2 2 2 2 2 2 2 2 2 2 2 2 2 2 2 64 67 68 67 2 2 2 2 2 2 2 2 2 2 2 2 64 65 66 65 66 67 68 65 66 67 2 2 2 2 2 2 2 2 2 2 2 2 2 2 2 2 2 2 2 2 2 73 74 74 75 2 2 2 2 2 69 69 70 71 72 69 2 2 69 69 2 69 70 71 72 2 2 2 2 2 2 2 2 2 2 2 2 0 39 76 41 77 78 79 80 81 82 83 84 85 86 87 0 88 89 90 91 92 93 94 95 96 97 98 99 100 101 102 103 
104 105 2 68 106 107 108 68 108 68 108 2 36 38 2 2 71 109 110 110 110 111 109 112 110 110 109 112 72 2 2 2 2 2 36 38 2 2 2 2 2 2 2 2 2 68 108 68 108 2 2 2 2 2 2 2 2 2 2 2 2 68 106 107 106 107 108 68 106 107 108 2 36 38 2 2 2 2 2 2 2 2 2 2 2 2 36 38 2 2 2 2 113 114 114 115 2 36 37 38 71 109 110 110 109 112 110 72 71 109 110 111 110 110 109 112 72 2 2 36 37 38 2 2 2 2 2 2 0 116 117 118 119 120 121 122 123 124 125 126 127 128 129 0 130 131 132 133 134 135 136 137 138 139 140 141 142 143 144 145 
146 105 2 68 147 106 148 68 148 68 148 2 2 2 2 149 150 151 150 151 150 151 151 152 150 151 151 152 150 153 2 2 2 2 2 69 69 70 71 72 2 70 2 2 2 68 148 68 148 2 2 2 73 74 74 74 74 74 74 75 2 68 147 106 147 106 148 68 147 106 148 2 2 2 2 2 73 75 2 2 73 74 74 74 74 75 2 2 2 2 73 75 113 114 114 115 2 2 2 149 150 151 150 151 151 152 150 151 151 152 150 151 150 151 151 152 150 153 2 2 2 69 69 70 2 70 71 72 0 0 154 155 156 157 0 0 0 158 0 159 160 0 0 0 161 162 163 164 165 166 167 168 169 170 171 172 173 174 175 0 
146 176 177 178 179 180 181 180 181 180 182 183 177 178 178 184 185 184 185 184 185 184 179 185 185 184 179 185 185 184 182 178 182 183 149 151 150 150 151 151 186 150 153 2 177 178 181 180 182 183 2 2 113 114 114 114 114 114 114 115 177 178 179 180 179 180 181 180 179 180 182 183 177 178 182 183 113 115 2 2 113 114 114 114 114 115 2 2 2 2 113 115 113 114 114 115 177 178 178 184 185 184 185 184 179 185 185 184 179 185 185 184 185 184 179 185 185 184 182 183 149 151 150 150 186 150 151 151 0 0 187 188 189 190 0 0 0 191 192 193 194 0 0 0 195 196 197 198 199 200 201 202 203 204 205 206 207 208 209 0 
210 211 212 212 212 212 212 212 212 212 212 212 212 212 212 212 212 212 212 212 212 212 212 212 212 212 212 212 212 212 212 212 212 212 212 212 212 212 212 212 212 212 212 212 212 212 212 212 212 212 73 75 113 114 114 114 114 114 114 115 212 212 212 212 212 212 212 212 212 212 212 212 212 212 212 212 213 214 212 212 113 114 114 114 114 115 212 212 73 75 213 214 113 114 114 115 212 212 212 212 212 212 212 212 212 212 212 212 212 212 212 212 212 212 212 212 212 212 212 212 212 212 212 212 212 212 212 212 0 0 215 216 217 218 0 0 0 219 220 221 222 223 0 0 224 225 226 227 228 229 230 231 232 233 234 235 236 237 238 0 
239 211 240 240 240 240 240 240 240 240 240 240 240 240 240 240 240 240 240 240 240 240 240 240 240 240 240 240 240 240 240 240 240 240 240 240 240 240 240 240 240 240 240 240 240 240 240 240 240 240 113 115 113 114 114 114 114 114 114 115 240 240 240 240 240 240 240 240 240 240 240 240 240 240 240 240 113 115 240 240 113 114 114 114 114 115 240 240 113 115 113 115 113 114 114 115 240 240 240 240 240 240 240 240 240 240 240 240 240 240 240 240 240 240 240 240 240 240 240 240 240 240 240 240 240 240 240 240 0 0 0 241 242 243 244 245 0 246 247 248 249 250 0 0 251 252 253 254 255 256 257 258 259 260 261 262 263 264 0 0 
265 266 267 267 267 267 267 267 267 267 267 267 267 267 267 267 267 267 267 267 267 267 267 267 267 267 267 267 267 267 267 267 267 268 240 240 73 75 240 240 73 75 240 240 73 75 240 240 73 75 213 214 113 114 114 114 114 114 114 115 240 240 240 240 73 74 74 75 240 240 269 267 267 267 267 267 267 267 267 267 267 267 267 267 267 267 267 268 213 214 213 214 113 114 114 115 240 240 240 240 270 240 240 240 270 240 240 240 270 240 240 240 269 267 267 267 267 267 267 267 267 267 267 267 267 267 267 267 0 0 0 0 0 0 271 272 0 0 0 0 0 0 0 0 273 274 275 276 277 278 279 280 281 282 283 284 285 286 287 0 
266 266 288 288 288 288 288 288 288 288 288 288 288 288 288 288 288 288 288 288 288 288 288 288 288 288 288 288 288 288 288 288 288 289 240 240 290 291 240 240 290 291 240 240 290 291 240 240 290 291 290 291 290 292 292 292 292 292 292 291 240 240 240 240 290 292 290 291 240 240 293 288 288 288 288 288 288 288 288 288 288 288 288 288 288 288 288 289 290 291 290 291 290 292 292 291 240 240 240 240 294 240 240 240 294 240 240 240 294 240 240 240 293 288 288 288 288 288 288 288 288 288 288 288 288 288 288 288 0 0 295 296 297 298 299 300 301 302 303 304 305 306 0 0 307 308 309 310 311 312 313 314 315 316 317 318 319 320 321 322 
323 323 323 323 323 323 323 323 323 323 323 323 323 323 323 323 323 323 323 323 323 323 323 323 323 323 323 323 323 323 323 323 323 323 240 240 240 240 240 240 240 240 240 240 240 240 240 240 240 240 240 240 240 240 240 240 240 240 240 240 240 240 240 240 240 240 240 240 240 240 324 323 323 323 323 323 323 323 323 323 323 323 323 323 323 323 323 323 240 240 240 240 240 240 240 240 240 240 240 240 240 240 240 240 240 240 240 240 240 240 240 240 324 323 323 323 323 323 323 323 323 323 323 323 323 323 323 323 0 0 325 326 327 328 329 330 331 332 333 334 335 336 0 0 337 338 339 340 341 342 343 344 345 346 347 348 349 0 0 0 
