3 0 0 1 82 9 88 1
5 0 0 3 169 256 8 1
6 0 0 259 138 158 9 1
7 0 0 418 105 159 11 1
8 0 0 580 74 155 5 1
9 0 0 801 170 32 5 1
10 0 0 867 139 27 6 1
11 0 0 929 105 31 8 1
12 0 0 963 161 126 5 1
13 0 0 1059 107 30 7 1
14 0 0 1095 74 88 7 1
15 0 0 1090 114 5 50 1
16 0 0 954 116 5 52 1
17 0 0 1158 174 88 5 1
18 0 0 1220 75 89 6 1
19 0 0 1282 141 60 6 1
46 0 0 1314 102 288 3 1
21 0 0 1380 174 60 6 1
22 0 0 1478 140 58 8 1
23 0 0 1573 171 121 5 1
24 0 0 1601 73 158 9 1
25 0 0 1829 170 25 7 1
26 0 0 1895 74 57 9 1
27 0 0 1987 140 27 5 1
28 0 0 2052 139 92 8 1
29 0 0 2147 106 91 8 1
30 0 0 2241 170 97 7 1
31 0 0 2234 117 3 52 1
32 0 0 2337 147 4 29 1
33 0 0 2338 137 60 9 1
34 0 0 2402 174 98 4 1
35 0 0 2394 146 6 30 1
36 0 0 2498 147 7 28 1
37 0 0 2498 136 91 8 1
38 0 0 2591 145 6 31 1
39 0 0 2591 170 65 5 1
40 0 0 2659 144 4 32 1
41 0 0 2658 137 62 8 1
42 0 0 2722 103 156 17 1
43 0 0 2947 168 109 7 1
47 0 0 1857 108 34 2 1
48 1 0 255 80 5 67 1
49 1 0 416 80 4 66 1
50 1 0 860 97 3 50 1
52 1 0 895 97 1 50 1
53 1 0 1149 127 4 53 1
54 1 0 1246 129 5 50 1
55 1 0 1886 23 6 59 1
56 1 0 1948 26 6 56 1
57 1 0 2943 115 5 60 1
58 2 0 326 103 2 4 1
59 2 0 375 101 3 5 1
60 2 0 877 108 2 3 1
61 2 0 1173 140 2 1 1
62 2 0 1213 137 1 3 1
63 2 0 1912 39 1 6 1
64 2 0 2972 132 1 2 1
65 3 0 526 69 3 6 1
66 3 0 652 35 1 5 1
67 3 0 1490 120 1 3 1
69 3 0 2079 103 1 2 1
70 3 0 2274 130 3 6 1
71 3 0 2459 130 4 1 1
72 3 0 2675 102 5 5 1
73 4 1 1067 132 4 4 1
74 4 1 1162 32 1 5 1
75 1 1 1088 29 4 51 1
76 1 1 1179 25 5 58 1
77 5 1 2835 65 6 4 1
78 6 1 348 94 3 3 1
79 6 1 440 65 2 3 1
80 6 1 703 39 4 3 1
81 6 1 1007 68 4 1 1
82 6 1 1163 127 2 2 1
83 6 1 1390 62 4 4 1
84 6 1 1502 63 5 7 1
85 6 1 1690 102 2 5 1
86 6 1 1832 137 6 8 1
87 6 1 2077 75 4 1 1
88 6 1 2197 64 3 3 1
89 6 1 2358 96 2 3 1
90 6 1 2516 97 2 7 1
91 6 1 2626 90 4 1 1
92 6 1 2820 63 2 4 1
105 7 1 3007 49 5 11 1
104 7 1 2677 49 3 3 1
103 7 1 2397 45 6 6 1
102 7 1 1437 35 4 5 0
101 7 1 1409 43 6 4 1
100 7 1 911 37 5 3 1
106 8 1 1567 66 3 4 1
107 8 1 1658 33 6 4 1
108 8 1 1619 33 1 6 0
