0 1 1 18 64 10 113 1
1 1 1 32 162 512 13 1
2 1 1 579 160 27 16 1
3 1 1 642 162 27 13 1
4 1 1 705 160 31 17 1
5 1 1 771 163 26 18 1
6 1 1 802 129 31 15 1
7 1 1 835 97 123 14 1
8 1 1 1026 159 63 15 1
9 1 1 1122 160 93 14 1
10 1 1 1219 98 31 13 1
11 1 1 1283 96 94 15 1
12 1 1 1408 132 34 9 1
13 1 1 1249 162 33 12 1
14 1 1 1378 160 30 16 1
15 1 1 1443 99 28 15 1
16 1 1 1475 62 63 17 1
17 1 1 1601 160 19 16 1
18 1 1 1663 160 18 13 1
19 1 1 1730 158 11 17 1
20 1 1 1793 159 254 17 1
21 1 1 2043 49 4 124 1
22 0 1 531 32 14 143 1
23 0 1 799 65 6 61 1
24 0 1 835 35 5 59 1
25 0 1 954 34 5 64 1
26 0 1 1121 65 6 108 1
27 0 1 1219 68 4 28 1
29 0 1 1254 64 5 57 1
30 0 1 1279 45 7 48 1
31 0 1 1369 41 8 51 1
32 0 1 1441 63 3 37 1
33 0 1 1473 32 2 26 1
34 0 1 1536 32 2 24 1
35 0 1 1794 105 6 67 1
36 2 1 257 121 3 24 1
37 2 1 300 119 5 23 1
38 2 1 346 117 6 24 1
39 2 1 452 111 6 29 1
41 2 1 1313 58 6 20 0
42 2 1 1456 70 7 15 0
43 2 1 1501 24 3 27 0
44 2 1 1896 118 7 25 0
45 2 1 1970 117 8 23 0
46 3 0 333 140 8 7 0
47 3 0 431 142 4 6 0
48 3 0 582 141 3 8 0
49 3 0 768 124 2 12 0
50 3 0 640 126 2 8 0
51 3 0 901 77 3 9 0
52 3 0 1148 140 4 9 0
53 3 0 1202 77 2 10 0
54 3 0 1329 74 2 6 0
55 3 0 1666 138 2 13 0
56 3 0 1874 140 3 9 0
57 4 0 818 101 2 17 0
58 4 0 1237 73 2 16 0
76 5 0 1364 120 3 12 1
65 1 0 1284 160 93 14 0
63 1 0 838 115 120 91 0
64 1 0 805 149 25 49 0
66 1 0 1217 161 28 12 0
72 6 0 197 131 13 8 0
74 6 0 1285 130 1 10 0
77 7 0 564 76 3 5 1
78 7 0 722 75 4 7 1
79 7 0 1052 81 4 8 1
80 7 0 1561 91 3 8 1
81 7 0 1722 75 3 3 1
82 7 0 1867 77 3 8 1
